verknüpfen|lier|
die Verknüpfung|le lien|
beschäftigen|s'occuper de|
angezeigen|approprier|
die Verfassung|état, constitution|
der Bereich|domaine, secteur d'activité|
sperren, gespert|bloqué|
der Finzatz|l'engagement|
stornieren|annuler|
die Bestellung|la commande|
verfahren|procéder|
untersuchen|examiner|
ermitteln|découvrir, identifier, enquêter|
der Betreuer|le responsable|
abgeschoben|laisser pour compte|
unbedingt|absolu, absolument|
zustimmung|approbation, assentiment|
übernehmen|reprendre|
annehmen|accepter|
unterstützung|le soutien|
Lass schnell von dir hören!|Envoie vite des nouvelles!|
weit und breit|loin de et à la ronde|
sich entspannen|se détendre|
unvergeßlich|innoubliable|
abfeuern|tirer un coup de feu|
durchaus|tout à fait|
unmittelbar|immédiatement|
die vorliebe|le goût, la prédilection|
derb|grossier, gaulois|
verhindern|empêcher|

